空空空空空空空空空空空空空
空空空空空空空空空空空空空
空空空空空空空空空空空空空
空砖砖砖砖砖砖砖砖砖砖空空
空砖砖砖砖砖砖砖砖砖砖空空
空空空空空空空空空空空空空
空空空空空空空空空空空空空
空空空空空空空空空空空空空
空空空空空空空空空空空空空
空空空空空空砖砖砖空空空空
空空空空空空空空空空空空空
空空空空空空空空空空空空空
空空空空空空空空空空空空空